!!!!#####!!!!!!!!!!!
!!!!#   #!!!!!!!!!!!
!!!!#   #!!!!!!!!!!!
!!###   ##!!!!!!!!!!
!!#      #!!!!!!!!!!
### # ## #!!!######!
#   # ## #####  ..#!
#               ..#!
##### ### # ##  ..#!
!!!!#     #########!
!!!!#######!!!!!!!!!
11 2
12 3
5 8
7 7
5 6
7 6
2 3
5 3